Bastusel_to_Grytfors_disch	Grytfors_upper
Bastusel_to_Grytfors_spill	Grytfors_upper
Bergnäs_to_Slagnäs_disch	Slagnäs_upper
Bergnäs_to_Slagnäs_spill	Slagnäs_upper
Båtfors_to_Finnfors_disch	Finnfors_upper
Båtfors_to_Finnfors_spill	Finnfors_upper
Finnfors_to_Granfors_disch	Granfors_upper
Finnfors_to_Granfors_spill	Granfors_upper
Gallejaur_to_Vargfors_disch	Vargfors_upper
Gallejaur_to_Vargfors_spill	Vargfors_upper
Granfors_to_Krångfors_disch	Krångfors_upper
Granfors_to_Krångfors_spill	Krångfors_upper
Grytfors_to_Gallejaur_disch	Gallejaur_upper
Grytfors_to_Gallejaur_spill	Gallejaur_upper
Krångfors_to_Selsfors_disch	Selsfors_upper
Krångfors_to_Selsfors_spill	Selsfors_upper
Rebnis_to_Bergnäs_disch	Bergnäs_upper
Rebnis_to_Bergnäs_spill	Bergnäs_upper
Rengård_to_Båtfors_disch	Båtfors_upper
Rengård_to_Båtfors_spill	Båtfors_upper
Sadva_to_Bergnäs_disch	Bergnäs_upper
Sadva_to_Bergnäs_spill	Bergnäs_upper
Selsfors_to_Kvistforsen_disch	Kvistforsen_upper
Selsfors_to_Kvistforsen_spill	Kvistforsen_upper
Slagnäs_to_Bastusel_disch	Bastusel_upper
Slagnäs_to_Bastusel_spill	Bastusel_upper
Vargfors_to_Rengård_disch	Rengård_upper
Vargfors_to_Rengård_spill	Rengård_upper